<13><Shoot'em up><88><67>
#################
########.########
########.########
########.########
####.##...##.####
####.##...##.####
####.##...##.####
#.##.#..x..#.##.#
#.##...xxx...##.#
#.##...xsx...##.#
#.#...........#.#
#..x..x...x..x..#
#...#.......#...#
#x.##..#.#..##.x#
#.######.######.#
#################
