<10><<3><59><49>
###########
###.###.###
##...#.x.##
#....x....#
#.#.x.x.#.#
#.......x.#
##.x.....##
###..#..###
####...####
#####s#####
###########
