<2><Level 2><8><6>
#########
####.####
####.####
####.####
#s..x...#
####.####
####.####
####.####
#########