<16><A new element><18><12>
#############
##....#.....#
##.##.#.###.#
##.#.d.d..#.#
##.#.##.#.#.#
#sd.d..d.d..#
##.#.##.#.###
##.....d..###
####....#####
#############
