<4><Level 4><30><25>
##########
#s..x....#
#.x..x..x#
#........#
#........#
#x....x..#
#...x.x..#
#.......x#
#..x...x.#
##########