<21><Rollercoaster><2><1>
################
#s...v#v<#>...v#
#v...........<.#
#.###>....^##..#
#>...........^.#
#^.....<^.....<#
################