<15><Sands of Time><38><33>
#################
#..............s#
#..x........x..##
#..............##
##..........x..##
##.............##
##.x.........x###
##......x.....###
########.####.###
##............###
##...........x###
##.............##
#..............##
#..............##
#################
