<18><Advanced Mode><60><49>
#####################
#s..........#....####
#.#.#######.#.##.####
#.#....####d....d...#
#..dd............##.#
#..dd.............#.#
##...#.####.#.##..#.#
##.dd.x........#.x..#
#..dd.......##.#..#.#
#.#..######.#.d...#.#
#.###........d.#.##.#
#....x......#.##d...#
#############....####
#####################
