<9><Memento Mori><58><48>
##############
#####.xx.#####
###........###
##.x......x.##
#...xx..xx...#
#..###..###..#
#..###..###..#
#..###..###..#
#...x....x...#
#s...#..#....#
###x.......###
###......x.###
####.#..#.####
##############
