<14><Caught in a web><70><59>
#############
#...x..x.x..#
#........x..#
#xx...x.....#
#..........x#
#x..dd.dd...#
#..x..s..x..#
#..........x#
#xd.dd.dd.d.#
#.....x.....#
#..x......xx#
#..x.x..x...#
#############
