<21><Moving on><9><7>
#########
#s...>..#
#.##.##v#
#.##.##.#
#.##.##.#
#.##^##.#
#.<.^...#
#########