<12><All aboard><70><61>
##################
##########.#######
#########.x.######
#########..x.#####
########...#x.####
########...#.x.###
#######.x..#..x.##
######.x.x.#...x.#
##########.#######
#....x.x...##.x..#
###..x..x.##...x.#
#####....##.....##
#######.......s###
##################
