<11><The Monster><115><93>
#####################
##....#########....##
##..#..#######..#..##
###...x..###..x...###
####....x###x....####
######...###...######
########.###.########
#.##.###.#s#.###.##.#
#..#..##.#.#.##..#..#
##....#...x...#....##
##...x..x...x..x...##
###.....#...#.....###
#####..##...##..#####
#####################
