<7><Caught in a web><70><63>
#############
#...x..x.x..#
#........x..#
#xx...x.....#
#..........x#
#x..........#
#..x..s..x..#
#..........x#
#x..........#
#.....x.....#
#..x......xx#
#..x.x..x...#
#############
