<21><Bouncing Around><15><9>
########
#.vs..##
#.....##
#......#
#......#
#..>...#
#......#
#>..^.^#
########
