<12><Level 12><54><46>
#############
#s..#...#...#
#.#.#.#.#.#.#
#...........#
###.#.#.#.###
#...#.#.#...#
#.#.#.#.#.#.#
#.....#.....#
#.###.#.###.#
#.....#.....#
#.#########.#
#.##.....##.#
#.....#.....#
#.###.#.###.#
#.....#.....#
#############
