###########
#s#.......#
#.#..#.##.#
#.#..#.##.#
#.#..#.##.#
#......##.#
####......#
###########