<24><level 24><99><99>
#########################
#s.......##.............#
########.##.####.######.#
#........##.............#
#.#.##.#.#######.######.#
#.#.##.#.........#......#
#.#.##.#######.#.#.##.###
#.......................#
#.#.##.###.###.######.#.#
#.#.##.......#..........#
#......###.#.#.######.###
###........#..........###
#########################



