<15><Level 15><99><99>
##################
#####........#####
#####...##...#####
###............###
###..#..#...#..###
#s......#........#
#.##........#.##.#
#........#..#.##.#
#....#...#..#....#
###..#...#..#..###
###..#......#..###
#######.##.#######
#######....#######
##################