############
#s......####
####.##.####
#.......####
#.##.......#
#.########.#
#..........#
############