<27><Level 27><99><99>
#################
###...#.....#####
###.#.#.#.....###
###.#.....##....#
###...#.......#.#
##s......######.#
##...##..#......#
##....#..#.##.#.#
##..............#
##.#..#..#..#.#.#
##....#..#..#...#
####........#####
#################


