................
.####.####.####.
.#....#....#....
.###s.#.##.#.##.
.#....#..#.#..#.
.####.####.####.
................