<13><Level 13><70><61>
#####################
###.......#.......###
###.##..#.#.#..##.###
#s......#.#.#.......#
#.#..#..#.#.#..#..#.#
#....#.........#....#
#########.#.#########
#....#....#....#....#
#.#..#.#..#..#.#..#.#
#...................#
###..#.#..#..#.#..###
###....#..#..#....###
#####################
