<26><Level 26><90><72>
#######################
###########.###########
##########...##########
#########.....#########
########..#....########
#######.........#######
######.......#...######
#####......#...#..#####
####.....#....#....####
###....#....#.#.#...###
###.#.....#.#.#.#.#.###
#s......#.............#
#######################