<21><Level 21><99><99>
##########
###....###
##..##..##
#..####..#
#.######.#
#.####...#
#.####...#
#.#..#####
#.#..###s#
#.#......#
#...#....#
##########