<29><Level 29><68><59>
###################
#......#########..#
#.#.##.#.......##.#
#.#....#.##.##....#
#.#.###..##.#...#.#
#.#...#...#.#..##.#
#.###.##..#.#...#.#
#...#.......##..#.#
#.#.####..#.....#.#
#s#.........#..##.#
###.####..#######.#
#......#......###.#
#.#.##.#..###.....#
#.........###.#####
#########.....#####
###################
