<22><Level 22><66><54>
#####################
#s..................#
#.#####.#####.#####.#
#.##......#......##.#
#.....#.#.#.#.#.....#
#.#.###.#.#.#.###.#.#
#.#.......#.......#.#
#.#.#.#.#.#.#.#.#.#.#
#.#.#.#...#...#.#.#.#
#.....#########.....#
#...#.....#.....#...#
#...#.....#.....#...#
#..#####.....#####..#
#####################
