<20><Level 20><99><99>
##############
##s.....##..##
##.####.##..##
##.#........##
#....##.##..##
#.#..#......##
#...........##
###..#.......#
###..##.##.#.#
###........#.#
###..##.####.#
###..##......#
##############
