<28><Level 28><46><34>
#############
#s........###
#.#######.###
#.#.....#...#
#.###.#.###.#
#.....#...#.#
#.#.##......#
#.#.....#.###
#.###.##....#
#...#.......#
###.###.#.#.#
###.....#...#
#############



