#################
#s#....#....#...#
#.#.##.#.##.#.#.#
#.#.......#.....#
#.#.####......###
#.#.#####.#.#..##
#.....###.#.#..##
##......#.#.#..##
#.....#........##
#...########..###
#################