<23><Level 23><99><84>
#####################
##.......###.......##
#.....##..#..##.....#
#.###.#...#...#.###.#
#........###........#
#####.#.#####.#.#####
#.....#.......#.....#
#.#.#.#.##.##.#.#.#.#
#.#........#......#.#
#.#####..#.#..#####.#
#.######.#.#..#####.#
#s..................#
#####################