<5><Level 5><5><3>
###########
#s........#
#..#.##.#.#
#..#.##...#
#..#.##.###
#..#......#
#..#.####.#
#..#.####.#
#.........#
##.#.####.#
##........#
###########