<6><Level 6><5><3>
#################
#s..............#
#.#.#########.#.#
###.......###.#.#
#.........###.#.#
#.#...........#.#
#.###########.#.#
#...............#
#################