<11><Level 11><52><42>
######################
#s.........#.#...#####
#.#####.##...........#
#........#...#.#.###.#
##.................#.#
#..................#.#
#....................#
#######..#..........##
#............#.#######
#.#.###..#..##.###...#
#.#................#.#
#.#####.##..##.#####.#
#.......######.......#
######################
