<14><Level 14><48><41>
#############
#s..#####...#
#.#.#...#.#.#
#.....#.....#
###.#.#.#.###
###.#.#.#.###
#...........#
#....###....#
###.......###
#...#.#.#...#
#.#.#.#.#.#.#
#.....#.....#
#############