<2><Level 2><5><3>
###########
#s.....#.##
######.#.##
#......#.##
#.######.##
#........##
###########