<10><Level 10><5><3>
###############
###.........###
###...#.##..###
####........###
#....##.##...##
#.##.##.#....##
#............##
##......#....s#
###############
