<7><Level 7><5><3>
####################
#..................#
#.#.#.##.#####.###.#
#..................#
###.#.##.#####.###.#
###.#.#..........#.#
###.#.#..#####.#.#.#
#...#.#..#####.#.#.#
#.#.#.#..#####.#.#.#
#................#.#
#.#.#..........#.#.#
#.#.####.#.#####.#.#
#.#..............#.#
#.######.#.#######.#
#s.......#.........#
####################