<25><Level 25><68><54>
#############
#..#.....#..#
#.....#.....#
#.##..#..##.#
#...........#
#..##.#.##..#
##..#.#.#..##
##....#....##
##..#####..##
###.......###
###...#...###
#####.s.#####
#############



